grüezi=hello
wie=how
gahts=goes
hoi=hi
mir=to me
guet=good
dir=to you
au=also
chasch=can
bitte=please
dä=that
Sack=bag
gäh=give
sicher=yeah
de=the
isch=is
da=there
was=what
hesch=have
dänn=then or so
dra=on or in
iipackt=to bag or pack
nid=not
vil=a lot
nur=just
es=a
bitzeli=little
chleider=clothes
bisch=are
scho=already
parat=ready
zum=to
choche=to cook
jä=yep
ich=I
chume=come
grad=right now
wämer=venn meer (when we)
ässe=eat
mier=we
gönd=go
go=to
znacht=dinner
hesch=to have


danke=thank you
und=and
uf=to or for
Italie=Italy
hend=have
luscht=desire or lust
das=this
wuchenendi=weekend
weil=because
Pizza=pizza
SpaghettiBolognese=spaghetti bolognese